START
0100000000000
0123456723220
0113335556330
0211115774440
0222311177530
0222333147540
0223333144630
0223311146570
0211113366750
3313333333333
START
4323327701002
3022256721222
3452331111333
5251111374443
7221326677553
7221333747545
4221111111632
3202333221657
3222331111755
3343321333777
START
0446666660223
0123411113223
0231115516333
0771546711111
0221332277533
0221111147545
0223333144632
0221111146576
0231111366755
3377771777777